**************
*E        ****
* **** *******
*            *
* **** ***** *
* **** ***** *
*           S*
**************

