********************
******E           **
******** ** ****  **
******** ** ****  **
******** ** ****  **
*S                **
********************
